R 848 480
SO textures/wall_2.xpm
WE textures/wall_3.xpm
EA textures/wall_4.xpm
S textures/sprite_1.xpm
F 205, 133, 36
C 135, 206, 235
NO textures/wall_1.xpm

11111111111111111111111111111
10000000000000000000000000001
10000000000000N00000000000001
10000000000000000000000000001
11111111111111111111111111111