R 900 400
SO	./assets/colorstone.xpm
WE	./assets/colorstone.xpm
EA	./assets/colorstone.xpm
S	./assets/colorstone.xpm
NO	./assets/colorstone.xpm
F 205, 133, 250
C 135, 206, 251

        1111111111111111111111111
        1000000000110000000000001
        1011000001110000002000001
        1001000000000000000000001
111111111011000001110000000000001
100000000011000001110111111111111
11110111111111011100000010001
11110111111111000001010010001
11000000110101011100000000001
10002000000000001100000010001
10000000000000001101010010001
11000001110101011111011110N0111
11110111 1110101 101111010001
11111111 1111111 111111111111