R 900 400
SO	./assets/colorstone.xpm
WE	./assets/colorstone.xpm
EA	./assets/colorstone.xpm
S	./assets/colorstone.xpm
NO	./assets/colorstone.xpm
F 139, 90, 43
C 135, 206, 235

111111
100021
1N0001
111111