R 800 500
EA	./assets/colorstone.xpm
NO	./assets/colorstone.xpm
WE	./assets/colorstone.xpm
SO	./assets/redbricks.xpm
S	./assets/pillar.xpm

F	139, 90, 140
C	135, 206, 1

111111111111111111111111111111111
1       1000000000110000000000001
1        001100000111000000200001
1       1001000000000000002000001
111111111011000001110000002000001
100000000011000001110111111111111
11110111111111011100000010001
11110111111111011101010010W01
11002000110101011100000000001
10002000000000000000000010201
10000000000000001101020012221
1100000111010101111102111000111
11110111 1110101 101111010001
11111111 1111111 111111111111