R 900 400
SO	./assets/colorstone.xpm
WE	./assets/colorstone.xpm
EA	./assets/colorstone.xpm
S	./assets/colorstone.xpm
NO	./assets/colorstone.xpm
F 205, 133, 36
C 135, 206, 235

     
 111
1N001
10001
11111