R 1000 600

SO	./assets/colorstone.xpm
WE	./assets/eagle.xpm
EA	./assets/eagle.xpm
NO	./assets/colorstone.xpm
S	./assets/hitler.xpm
F	139, 90, 14
C	135, 206, 135

11111111111111111111111111111
10000000001100000000000000001
10110000011100000000000010001
10010000000000000000000010001
10110000011100000000000010001
10000000001100000111011110001
11110111111111011100000010001
11110111111111011101010010001
11000000110101011100000010001
10000000000000001100000010001
10000000000000001101010010001
11000000110101000000002200001
11110111110101000000020000001
100000000011000001200W0010001
10000000000000001010000101001
10000000001000010001010001001
10000000001101000000000000001
10000000000100000001010000001
11111111111111111111111111111