R 848 380
NO textures/wall_1.xpm
SO textures/wall_2.xpm
WE textures/wall_3.xpm
EA textures/wall_4.xpm
S textures/sprite_1.xpm
SC textures/sprite_3.xpm
ST textures/sky_1.xpm
FT textures/floor_1.xpm

11111111111111111111111111111
10000000001100000000000000001
10110000011100000000000010001
10310000000000000000000010001
10110000011100000000000010001
10000000001100000111011110001
11110111111111011100000010001
11110111111111011100000010001
11000000110101011101010010001
10000000000000001100300010001
10000000000000001101010010001
11000000110101000000000000001
11110111113101000000000000001
10000000001100000100000010001
10000000000000001010000131001
10000000001000010001010201001
10000000001101000000N00000001
10000000003100000001010000001
11111111111111111111111111111
